
NO ./asset/nord.xpm


	SO     ./asset/sud.xpm
F 60,60,60


  EA ./asset/est.xpm
  WE./asset/ouest.xpm

  
C 0,0,155

11111111111111111111111111111111111111
111000000000000000000000000011
100000111111111111111000000011
1110001111111111111110001111111
1000000000000N0000000000000011
100000111111111111111000000011
100000000000000000000000000011
11111111111111111111111111111111111111


