
SO ./asset/murgris.xpm


F 50,50,0


  EA ./asset/mur_mouse.xpm 
  NO ./asset/murrouge.xpm

  WE                                                                       ./asset/mur-en-pierre.xpm
  
C				0,000,0 


    1111111111111111111111111111111111
11111111110000000000000000000000000001
         1111111110111111111111111111111
         111111111011111111     11111111111
         1000111110111111111111110000000001
         1111111100111          11000000011
        11W1111110111   11111111111111111111
         10000000001
         11111111101
         10000000001
         10000000111
         11111111111
